20
20
EEDED##D##DED#EEEDDE
EW #         #  D  D
D  E   DT    #%    D
#  #   D     #  D  D
#K E   D   I #     #
DKKE   #     #  D  D
D  E   D     #  D  D
D KE        I#   I #
E  #     E         D
# KE       E       #
E  K *   EEEI IE#EE#
#       EE#E    D  D
EK    *   #DDD *DD #
#         ##D    D D
EK     *  DDD*   D E
#   E   *   D  #   E
#   E       D* E   D
D   #G   ****  #  %E
D   E          E   D
E#####DD#DD#D#D#D##E